{
    "tiles": [
        [9, 9, 9, 9, 9, 9, 9, 9, 9, 9, 9, 9, 9, 9, 9, 0],
        [4, 4, 9, 9, 9, 9, 9, 9, 9, 9, 9, 9, 9, 9, 0, 0],
        [4, 4, 4, 9, 4, 4, 4, 4, 4, 4, 4, 9, 4, 0, 0, 0],
        [4, 4, 4, 4, 4, 4, 4, 4, 4, 4, 4, 4, 4, 0, 0, 0],
        [4, 4, 4, 4, 9, 4, 4, 4, 9, 4, 4, 4, 4, 0, 0, 0],
        [4, 4, 4, 4, 4, 4, 4, 0, 0, 0, 0, 4, 4, 0, 0, 0],
        [4, 4, 4, 4, 4, 4, 4, 0, 0, 0, 0, 4, 4, 4, 0, 0],
        [4, 4, 4, 0, 4, 4, 4, 0, 4, 4, 0, 4, 4, 0, 0, 4],
        [4, 4, 0, 0, 4, 4, 0, 0, 4, 0, 0, 0, 4, 0, 4, 4],
        [4, 4, 0, 0, 0, 4, 0, 0, 0, 0, 0, 0, 0, 0, 0, 4],
        [4, 4, 0, 0, 4, 4, 0, 4, 0, 4, 0, 0, 0, 0, 4, 4],
        [4, 4, 0, 4, 4, 4, 0, 4, 4, 4, 4, 0, 0, 0, 4, 4],
        [4, 4, 4, 4, 4, 4, 4, 4, 4, 4, 4, 4, 4, 0, 0, 4],
        [4, 4, 4, 4, 4, 9, 4, 9, 4, 4, 4, 4, 4, 4, 0, 4],
        [4, 4, 4, 4, 4, 4, 4, 4, 4, 4, 4, 4, 4, 4, 0, 0],
        [4, 4, 4, 4, 4, 4, 4, 4, 4, 4, 4, 4, 4, 4, 4, 0]
    ],
    "coord": { "x": 0, "y": 0 },
    "size": { "x": 16, "y": 16 },
    "walkables": [1, 2, 3, 4, 5, 6, 7],
    "opaques": [8, 9, 10, 11],
    "entries": { "south": true, "north": false, "est": false, "west": true }
}
