{
    "tiles": [
        [9, 4, 4, 4, 4, 4, 4, 4, 4, 4, 4, 4, 4, 4, 4, 9],
        [9, 4, 4, 4, 4, 4, 4, 4, 4, 4, 4, 4, 4, 4, 4, 9],
        [9, 9, 9, 4, 4, 4, 4, 4, 4, 4, 4, 9, 4, 4, 4, 9],
        [9, 9, 4, 4, 4, 4, 4, 4, 4, 4, 4, 4, 4, 9, 4, 9],
        [9, 9, 4, 4, 9, 4, 4, 4, 9, 4, 4, 4, 4, 9, 9, 9],
        [9, 9, 9, 9, 9, 4, 9, 9, 9, 4, 4, 9, 4, 4, 9, 9],
        [9, 9, 4, 9, 4, 4, 4, 4, 4, 4, 4, 9, 9, 4, 4, 9],
        [9, 4, 4, 9, 4, 4, 4, 4, 4, 4, 9, 9, 9, 4, 4, 9],
        [9, 9, 4, 4, 4, 9, 9, 4, 4, 4, 4, 4, 4, 4, 4, 9],
        [9, 9, 9, 4, 9, 9, 4, 4, 4, 4, 4, 4, 4, 4, 4, 9],
        [9, 9, 9, 4, 4, 4, 9, 4, 9, 4, 9, 4, 4, 9, 9, 9],
        [9, 9, 9, 4, 4, 4, 9, 4, 4, 4, 4, 4, 9, 9, 4, 9],
        [9, 9, 4, 4, 4, 4, 4, 4, 4, 4, 4, 4, 4, 4, 4, 9],
        [9, 4, 4, 4, 4, 9, 4, 9, 4, 4, 4, 4, 4, 4, 4, 9],
        [9, 4, 4, 4, 4, 4, 4, 4, 4, 4, 4, 4, 4, 4, 4, 9],
        [9, 4, 4, 4, 4, 4, 4, 4, 4, 4, 4, 4, 4, 4, 4, 9]
    ],
    "coord": { "x": 0, "y": 0 },
    "size": { "x": 16, "y": 16 },
    "walkables": [1, 2, 3, 4, 5, 6, 7],
    "opaques": [8, 9, 10, 11],
    "entries": { "south": true, "north": true, "est": false, "west": false }
}
