{
    "tiles": [
        [8, 2, 2, 2, 2, 2, 2, 2, 2, 2, 2, 2, 2, 2, 2, 9],
        [0, 1, 2, 2, 2, 2, 2, 2, 2, 2, 2, 2, 2, 2, 2, 2],
        [0, 1, 1, 2, 2, 2, 2, 2, 2, 2, 2, 2, 2, 2, 2, 2],
        [0, 1, 9, 9, 2, 2, 2, 2, 2, 2, 9, 2, 2, 2, 2, 2],
        [0, 0, 1, 2, 2, 2, 2, 2, 2, 2, 2, 2, 2, 2, 2, 2],
        [0, 1, 1, 2, 2, 2, 2, 8, 9, 2, 2, 2, 2, 2, 2, 2],
        [0, 0, 0, 2, 2, 2, 2, 2, 2, 2, 2, 2, 2, 2, 2, 2],
        [0, 1, 1, 2, 2, 2, 2, 2, 2, 2, 2, 2, 2, 2, 2, 2],
        [0, 0, 0, 1, 2, 2, 9, 8, 8, 9, 2, 9, 9, 8, 2, 2],
        [0, 0, 1, 1, 1, 1, 1, 1, 8, 2, 2, 2, 9, 0, 2, 2],
        [0, 0, 0, 1, 1, 8, 4, 4, 9, 1, 1, 9, 0, 0, 2, 2],
        [0, 0, 1, 1, 0, 0, 4, 4, 0, 1, 1, 9, 0, 1, 2, 2],
        [0, 0, 0, 0, 0, 0, 4, 4, 0, 0, 1, 0, 0, 1, 1, 2],
        [0, 1, 0, 0, 1, 0, 4, 4, 0, 0, 1, 1, 1, 1, 1, 1],
        [0, 1, 0, 0, 0, 0, 0, 0, 0, 1, 1, 0, 0, 0, 1, 1],
        [0, 0, 0, 0, 0, 0, 0, 0, 0, 0, 0, 0, 0, 0, 0, 0]
    ],
    "entries": { "south": false, "north": true, "est": true, "west": false }
}
