{
    "tiles": [
        [2, 2, 2, 2, 2, 2, 2, 2, 2, 2, 2, 2, 2, 2, 2, 2],
        [2, 2, 2, 2, 2, 2, 2, 2, 2, 2, 2, 2, 2, 2, 2, 2],
        [2, 2, 2, 2, 2, 2, 1, 2, 2, 2, 2, 2, 2, 2, 2, 2],
        [2, 2, 2, 2, 2, 2, 1, 1, 2, 9, 2, 2, 2, 2, 2, 2],
        [2, 1, 0, 0, 9, 2, 2, 1, 1, 1, 2, 2, 2, 10, 2, 2],
        [2, 1, 0, 0, 8, 2, 1, 1, 1, 0, 0, 0, 2, 2, 2, 2],
        [2, 1, 1, 0, 1, 1, 1, 1, 0, 0, 0, 2, 2, 2, 2, 2],
        [2, 1, 1, 1, 1, 1, 1, 0, 0, 0, 2, 2, 2, 2, 2, 2],
        [2, 2, 1, 1, 1, 1, 1, 0, 0, 8, 9, 2, 2, 2, 2, 2],
        [2, 2, 1, 1, 1, 1, 1, 0, 0, 0, 9, 2, 2, 2, 2, 2],
        [2, 2, 1, 0, 1, 1, 1, 2, 0, 8, 2, 2, 10, 9, 2, 2],
        [2, 2, 1, 0, 0, 1, 1, 1, 1, 1, 2, 2, 1, 2, 2, 2],
        [2, 2, 1, 0, 0, 8, 2, 2, 2, 1, 2, 2, 1, 1, 2, 2],
        [2, 2, 2, 1, 1, 1, 1, 1, 2, 2, 2, 1, 1, 1, 2, 2],
        [2, 2, 2, 2, 2, 2, 1, 2, 2, 2, 2, 1, 2, 2, 2, 2],
        [2, 2, 2, 2, 2, 2, 2, 2, 2, 2, 2, 2, 2, 2, 2, 2]
    ],
    "entries": { "south": true, "north": true, "est": true, "west": true }
}
