{
    "tiles": [
        [2, 2, 2, 2, 2, 2, 2, 2, 2, 2, 2, 2, 2, 2, 2, 9],
        [2, 2, 2, 2, 2, 2, 2, 2, 2, 2, 2, 2, 2, 2, 2, 8],
        [2, 2, 2, 2, 2, 2, 2, 2, 2, 2, 2, 2, 2, 2, 2, 9],
        [2, 2, 9, 8, 2, 2, 2, 2, 2, 2, 9, 2, 2, 2, 9, 8],
        [2, 2, 2, 2, 2, 2, 2, 2, 2, 2, 2, 2, 2, 2, 8, 8],
        [2, 2, 2, 2, 2, 2, 2, 8, 9, 2, 2, 2, 2, 2, 8, 8],
        [2, 2, 2, 2, 2, 2, 2, 2, 2, 2, 2, 2, 2, 2, 9, 9],
        [2, 2, 2, 2, 2, 2, 2, 2, 2, 2, 2, 2, 2, 2, 9, 8],
        [2, 2, 2, 2, 2, 2, 9, 8, 9, 9, 2, 9, 9, 10, 0, 8],
        [2, 2, 2, 2, 2, 1, 1, 1, 10, 1, 1, 1, 9, 0, 0, 9],
        [2, 2, 2, 2, 2, 8, 8, 1, 8, 1, 1, 9, 0, 0, 9, 9],
        [2, 2, 2, 2, 2, 1, 1, 1, 1, 1, 1, 9, 0, 0, 0, 0],
        [2, 2, 2, 2, 1, 1, 1, 1, 0, 0, 1, 0, 0, 0, 0, 0],
        [2, 2, 2, 1, 1, 0, 0, 0, 0, 0, 1, 0, 0, 0, 0, 0],
        [2, 2, 0, 0, 0, 0, 0, 0, 0, 1, 1, 0, 0, 0, 0, 0],
        [0, 0, 0, 0, 0, 0, 0, 0, 0, 0, 0, 0, 0, 0, 0, 0]
    ],
    "entries": { "south": false, "north": true, "est": false, "west": true }
}
