{
    "tiles": [
        [9, 9, 9, 9, 8, 9, 9, 9, 8, 8, 9, 0, 0, 0, 9, 8],
        [2, 1, 9, 0, 0, 0, 10, 8, 8, 8, 9, 0, 0, 0, 1, 2],
        [2, 1, 1, 1, 0, 0, 0, 1, 1, 1, 0, 0, 0, 0, 1, 2],
        [2, 2, 9, 1, 1, 1, 1, 1, 1, 1, 0, 0, 0, 1, 1, 2],
        [2, 2, 2, 2, 1, 1, 1, 1, 1, 1, 0, 0, 0, 1, 1, 2],
        [2, 2, 2, 2, 2, 2, 1, 1, 1, 1, 0, 0, 0, 1, 2, 2],
        [2, 2, 2, 2, 2, 2, 2, 2, 2, 1, 4, 4, 4, 1, 2, 2],
        [2, 2, 2, 2, 2, 2, 2, 2, 2, 1, 4, 4, 4, 1, 2, 2],
        [2, 2, 2, 2, 8, 8, 9, 9, 1, 1, 0, 0, 0, 1, 1, 2],
        [2, 2, 2, 2, 2, 2, 2, 2, 1, 0, 0, 0, 0, 1, 2, 2],
        [2, 2, 2, 2, 8, 9, 8, 1, 1, 0, 0, 0, 0, 1, 2, 2],
        [2, 2, 2, 2, 2, 2, 1, 1, 1, 0, 0, 0, 0, 1, 2, 2],
        [2, 2, 2, 2, 2, 1, 1, 1, 1, 10, 0, 0, 0, 0, 2, 2],
        [2, 2, 2, 2, 1, 9, 1, 1, 1, 9, 1, 0, 0, 0, 2, 2],
        [2, 2, 8, 8, 9, 9, 0, 0, 8, 1, 1, 9, 0, 0, 2, 2],
        [9, 9, 9, 8, 9, 0, 0, 0, 0, 8, 9, 9, 0, 0, 8, 8]
    ],
    "entries": { "south": false, "north": false, "est": true, "west": true }
}
