{
    "tiles": [
        [9, 9, 9, 9, 9, 9, 8, 9, 8, 9, 8, 9, 9, 8, 9, 0],
        [2, 2, 9, 9, 8, 9, 8, 8, 8, 9, 9, 8, 8, 9, 0, 0],
        [2, 2, 2, 9, 2, 2, 2, 2, 1, 1, 1, 9, 1, 0, 0, 0],
        [2, 2, 2, 2, 2, 2, 2, 2, 1, 1, 1, 1, 1, 0, 0, 0],
        [2, 2, 2, 2, 8, 2, 2, 2, 8, 1, 1, 1, 1, 0, 0, 0],
        [2, 2, 2, 2, 2, 2, 2, 0, 0, 0, 0, 1, 1, 0, 0, 0],
        [2, 2, 2, 2, 2, 2, 2, 0, 0, 0, 0, 1, 1, 1, 0, 0],
        [2, 2, 2, 0, 2, 2, 2, 0, 2, 2, 0, 1, 1, 0, 0, 1],
        [2, 2, 0, 0, 2, 2, 0, 0, 2, 0, 0, 0, 1, 0, 1, 1],
        [2, 2, 0, 0, 0, 2, 0, 0, 0, 0, 0, 0, 0, 0, 0, 1],
        [2, 2, 0, 0, 2, 2, 0, 2, 0, 2, 0, 0, 0, 0, 1, 1],
        [2, 2, 0, 2, 2, 2, 0, 2, 2, 2, 2, 0, 0, 0, 1, 1],
        [2, 2, 2, 2, 2, 2, 2, 2, 2, 2, 2, 2, 2, 0, 0, 1],
        [2, 2, 2, 2, 2, 9, 2, 8, 2, 2, 2, 2, 2, 2, 0, 1],
        [2, 2, 2, 2, 2, 2, 2, 2, 2, 2, 2, 2, 2, 2, 0, 0],
        [2, 2, 2, 2, 2, 2, 2, 2, 2, 2, 2, 2, 2, 2, 2, 0]
    ],
    "entries": { "south": true, "north": false, "est": false, "west": true }
}
