{
    "tiles": [
        [9, 2, 2, 2, 2, 2, 2, 2, 2, 2, 2, 2, 2, 2, 2, 10],
        [0, 6, 1, 1, 2, 4, 1, 1, 2, 2, 2, 2, 2, 2, 2, 0],
        [0, 0, 0, 0, 4, 4, 0, 0, 8, 8, 2, 2, 2, 2, 0, 0],
        [0, 0, 0, 0, 4, 4, 0, 0, 0, 9, 2, 2, 2, 2, 0, 0],
        [0, 3, 0, 0, 4, 4, 4, 4, 4, 4, 0, 0, 0, 2, 0, 0],
        [0, 3, 0, 0, 4, 4, 0, 0, 0, 0, 0, 0, 0, 2, 2, 0],
        [0, 0, 0, 0, 4, 4, 0, 4, 4, 0, 0, 0, 0, 2, 2, 0],
        [0, 0, 0, 0, 4, 4, 0, 0, 0, 0, 0, 0, 0, 2, 2, 0],
        [11, 11, 12, 11, 3, 3, 11, 12, 11, 0, 11, 2, 11, 11, 2, 0],
        [0, 7, 3, 3, 3, 3, 3, 3, 7, 0, 3, 3, 3, 2, 2, 0],
        [0, 1, 7, 7, 3, 3, 7, 7, 1, 1, 7, 2, 2, 2, 2, 0],
        [0, 0, 1, 7, 3, 7, 1, 1, 1, 1, 1, 2, 2, 2, 0, 0],
        [0, 0, 1, 1, 7, 1, 1, 1, 1, 1, 1, 2, 2, 2, 2, 0],
        [0, 1, 1, 1, 7, 1, 1, 1, 1, 1, 1, 2, 2, 2, 2, 0],
        [0, 1, 1, 1, 7, 1, 1, 1, 1, 1, 1, 2, 2, 2, 2, 0],
        [11, 11, 12, 11, 12, 11, 11, 12, 11, 11, 11, 11, 11, 11, 11, 11]
    ],
    "entries": { "south": false, "north": true, "est": false, "west": false }
}
