{
    "tiles": [
        [4, 4, 4, 4, 4, 4, 4, 4, 4, 4, 4, 4, 4, 4, 4, 4],
        [4, 4, 4, 4, 4, 4, 4, 4, 4, 4, 4, 4, 4, 4, 4, 4],
        [4, 4, 4, 4, 4, 4, 4, 4, 4, 4, 4, 4, 4, 4, 4, 4],
        [4, 4, 4, 4, 4, 4, 4, 4, 2, 4, 4, 2, 2, 2, 4, 4],
        [4, 4, 4, 4, 4, 4, 4, 2, 2, 4, 4, 2, 4, 2, 4, 4],
        [4, 4, 4, 4, 4, 4, 2, 4, 2, 4, 4, 2, 4, 2, 4, 4],
        [4, 4, 4, 4, 4, 4, 4, 4, 2, 4, 4, 2, 4, 2, 4, 4],
        [4, 4, 4, 4, 4, 4, 4, 4, 2, 4, 4, 2, 4, 2, 4, 4],
        [4, 4, 4, 4, 2, 2, 4, 4, 2, 4, 4, 2, 4, 2, 4, 4],
        [4, 4, 4, 4, 4, 4, 4, 4, 2, 4, 4, 2, 4, 2, 4, 4],
        [4, 4, 4, 4, 4, 4, 4, 4, 2, 4, 4, 2, 4, 2, 4, 4],
        [4, 4, 4, 4, 4, 4, 4, 4, 2, 4, 4, 2, 2, 2, 4, 4],
        [4, 4, 4, 4, 4, 4, 4, 4, 4, 4, 4, 4, 4, 4, 4, 4],
        [4, 4, 4, 4, 4, 4, 4, 4, 4, 4, 4, 4, 4, 4, 4, 4],
        [4, 4, 4, 4, 4, 4, 4, 4, 4, 4, 4, 4, 4, 4, 4, 4],
        [4, 4, 4, 4, 4, 4, 4, 4, 4, 4, 4, 4, 4, 4, 4, 4]
    ],
    "sizeX": 16,
    "sizeY": 16,
    "blocking": [0, 8, 9, 10, 11, 12],
    "opaque": [8, 9, 10, 11]
}
