{
    "tiles": [
        [9, 2, 1, 1, 4, 4, 1, 6, 2, 10, 2, 2, 2, 2, 2, 2],
        [2, 6, 1, 0, 4, 4, 0, 0, 2, 2, 2, 2, 2, 2, 2, 2],
        [6, 1, 0, 0, 4, 4, 0, 0, 8, 8, 2, 2, 2, 2, 2, 2],
        [0, 0, 0, 0, 4, 4, 0, 0, 0, 9, 2, 2, 2, 2, 2, 2],
        [0, 3, 0, 0, 4, 4, 4, 4, 4, 4, 0, 0, 0, 2, 0, 0],
        [3, 3, 0, 0, 4, 4, 0, 0, 0, 0, 0, 0, 0, 2, 2, 0],
        [3, 0, 0, 0, 4, 4, 0, 4, 4, 0, 0, 0, 0, 2, 2, 0],
        [3, 0, 0, 0, 4, 4, 0, 0, 0, 0, 0, 0, 0, 2, 2, 0],
        [11, 11, 12, 11, 3, 3, 11, 12, 11, 0, 11, 2, 11, 11, 2, 11],
        [3, 7, 3, 3, 3, 3, 3, 3, 7, 0, 3, 3, 3, 2, 2, 2],
        [7, 1, 7, 7, 3, 3, 7, 7, 1, 1, 7, 2, 2, 2, 2, 2],
        [1, 1, 1, 7, 3, 7, 1, 1, 1, 1, 1, 2, 2, 2, 2, 2],
        [1, 1, 1, 1, 7, 1, 1, 1, 1, 1, 1, 2, 2, 2, 2, 2],
        [1, 1, 1, 1, 7, 1, 1, 1, 1, 1, 1, 2, 2, 2, 2, 2],
        [1, 1, 1, 1, 7, 1, 1, 1, 1, 1, 1, 2, 2, 2, 2, 2],
        [11, 11, 12, 11, 12, 11, 11, 12, 11, 11, 11, 2, 2, 2, 2, 2]
    ],
    "sizeX": 16,
    "sizeY": 16,
    "walkables": [1, 2, 3, 4, 5, 6, 7],
    "opaque": [8, 9, 10, 11]
}
