{
    "tiles": [
        [9, 2, 1, 1, 4, 4, 1, 6, 2, 10, 2],
        [2, 6, 1, 0, 4, 4, 0, 0, 2, 2, 2],
        [6, 1, 0, 0, 4, 4, 0, 0, 8, 8, 2],
        [0, 0, 0, 0, 4, 4, 0, 0, 0, 9, 2],
        [0, 3, 0, 0, 4, 4, 4, 4, 4, 4, 0],
        [3, 3, 0, 0, 4, 4, 0, 0, 0, 0, 0],
        [3, 0, 0, 0, 4, 4, 0, 4, 4, 0, 0],
        [3, 0, 0, 0, 4, 4, 0, 0, 0, 0, 0],
        [11, 11, 12, 11, 3, 3, 11, 12, 11, 0, 11],
        [3, 7, 3, 3, 3, 3, 3, 3, 7, 0, 3],
        [7, 1, 7, 7, 3, 3, 7, 7, 1, 1, 7],
        [1, 1, 1, 7, 3, 7, 1, 1, 1, 1, 1],
        [1, 1, 1, 1, 7, 1, 1, 1, 1, 1, 1],
        [11, 11, 12, 11, 12, 11, 11, 12, 11, 11, 11 ]
    ],
    "sizeX": 11,
    "sizeY": 14,
    "blocking": [0, 8, 9, 10, 11, 12],
    "opaque": [8, 9, 10, 11]
}
